"filename", "language", "JavaScript", "JSON", "Markdown", "comment", "blank", "total"
"c:\Users\Felix\OneDrive\Desktop\LSPD\Butler Next Gen\FIB - Nightmare - Recode\README.md", "Markdown", 0, 0, 20, 0, 10, 30
"c:\Users\Felix\OneDrive\Desktop\LSPD\Butler Next Gen\FIB - Nightmare - Recode\commands\applyCommand.js", "JavaScript", 135, 0, 0, 6, 20, 161
"c:\Users\Felix\OneDrive\Desktop\LSPD\Butler Next Gen\FIB - Nightmare - Recode\commands\banCommand.js", "JavaScript", 128, 0, 0, 6, 15, 149
"c:\Users\Felix\OneDrive\Desktop\LSPD\Butler Next Gen\FIB - Nightmare - Recode\commands\databaseCommandgroup.js", "JavaScript", 357, 0, 0, 4, 51, 412
"c:\Users\Felix\OneDrive\Desktop\LSPD\Butler Next Gen\FIB - Nightmare - Recode\commands\statsCommand.js", "JavaScript", 101, 0, 0, 7, 22, 130
"c:\Users\Felix\OneDrive\Desktop\LSPD\Butler Next Gen\FIB - Nightmare - Recode\commands\stopCommand.js", "JavaScript", 73, 0, 0, 6, 11, 90
"c:\Users\Felix\OneDrive\Desktop\LSPD\Butler Next Gen\FIB - Nightmare - Recode\database\models.js", "JavaScript", 128, 0, 0, 0, 28, 156
"c:\Users\Felix\OneDrive\Desktop\LSPD\Butler Next Gen\FIB - Nightmare - Recode\ecosystem.config.js", "JavaScript", 11, 0, 0, 0, 0, 11
"c:\Users\Felix\OneDrive\Desktop\LSPD\Butler Next Gen\FIB - Nightmare - Recode\events\guildMemberAdd.js", "JavaScript", 78, 0, 0, 6, 14, 98
"c:\Users\Felix\OneDrive\Desktop\LSPD\Butler Next Gen\FIB - Nightmare - Recode\events\guildMemberRemove.js", "JavaScript", 23, 0, 0, 5, 5, 33
"c:\Users\Felix\OneDrive\Desktop\LSPD\Butler Next Gen\FIB - Nightmare - Recode\events\interactionCreate.js", "JavaScript", 40, 0, 0, 5, 5, 50
"c:\Users\Felix\OneDrive\Desktop\LSPD\Butler Next Gen\FIB - Nightmare - Recode\events\messageCreate.js", "JavaScript", 56, 0, 0, 6, 8, 70
"c:\Users\Felix\OneDrive\Desktop\LSPD\Butler Next Gen\FIB - Nightmare - Recode\events\ready.js", "JavaScript", 151, 0, 0, 11, 25, 187
"c:\Users\Felix\OneDrive\Desktop\LSPD\Butler Next Gen\FIB - Nightmare - Recode\events\typingStart.js", "JavaScript", 23, 0, 0, 4, 7, 34
"c:\Users\Felix\OneDrive\Desktop\LSPD\Butler Next Gen\FIB - Nightmare - Recode\index.js", "JavaScript", 89, 0, 0, 7, 15, 111
"c:\Users\Felix\OneDrive\Desktop\LSPD\Butler Next Gen\FIB - Nightmare - Recode\interactions\acceptFormButton.js", "JavaScript", 104, 0, 0, 8, 21, 133
"c:\Users\Felix\OneDrive\Desktop\LSPD\Butler Next Gen\FIB - Nightmare - Recode\interactions\acceptTalkButton.js", "JavaScript", 105, 0, 0, 8, 22, 135
"c:\Users\Felix\OneDrive\Desktop\LSPD\Butler Next Gen\FIB - Nightmare - Recode\interactions\acknowledgeButton.js", "JavaScript", 37, 0, 0, 4, 4, 45
"c:\Users\Felix\OneDrive\Desktop\LSPD\Butler Next Gen\FIB - Nightmare - Recode\interactions\closeTicketButton.js", "JavaScript", 154, 0, 0, 5, 24, 183
"c:\Users\Felix\OneDrive\Desktop\LSPD\Butler Next Gen\FIB - Nightmare - Recode\interactions\createJoinAppointmentButton.js", "JavaScript", 27, 0, 0, 4, 3, 34
"c:\Users\Felix\OneDrive\Desktop\LSPD\Butler Next Gen\FIB - Nightmare - Recode\interactions\createJoinAppointmentModal.js", "JavaScript", 113, 0, 0, 6, 17, 136
"c:\Users\Felix\OneDrive\Desktop\LSPD\Butler Next Gen\FIB - Nightmare - Recode\interactions\createTalkAppointmentButton.js", "JavaScript", 27, 0, 0, 4, 3, 34
"c:\Users\Felix\OneDrive\Desktop\LSPD\Butler Next Gen\FIB - Nightmare - Recode\interactions\createTalkAppointmentModal.js", "JavaScript", 112, 0, 0, 6, 17, 135
"c:\Users\Felix\OneDrive\Desktop\LSPD\Butler Next Gen\FIB - Nightmare - Recode\interactions\createTicketButton.js", "JavaScript", 70, 0, 0, 8, 7, 85
"c:\Users\Felix\OneDrive\Desktop\LSPD\Butler Next Gen\FIB - Nightmare - Recode\interactions\createTicketModal.js", "JavaScript", 206, 0, 0, 10, 26, 242
"c:\Users\Felix\OneDrive\Desktop\LSPD\Butler Next Gen\FIB - Nightmare - Recode\interactions\declineTicketButton.js", "JavaScript", 117, 0, 0, 9, 24, 150
"c:\Users\Felix\OneDrive\Desktop\LSPD\Butler Next Gen\FIB - Nightmare - Recode\interactions\expressCriticismButton.js", "JavaScript", 26, 0, 0, 5, 3, 34
"c:\Users\Felix\OneDrive\Desktop\LSPD\Butler Next Gen\FIB - Nightmare - Recode\interactions\expressCriticismModal.js", "JavaScript", 101, 0, 0, 6, 12, 119
"c:\Users\Felix\OneDrive\Desktop\LSPD\Butler Next Gen\FIB - Nightmare - Recode\interactions\expressPraiseButton.js", "JavaScript", 26, 0, 0, 5, 3, 34
"c:\Users\Felix\OneDrive\Desktop\LSPD\Butler Next Gen\FIB - Nightmare - Recode\interactions\expressPraiseModal.js", "JavaScript", 101, 0, 0, 6, 12, 119
"c:\Users\Felix\OneDrive\Desktop\LSPD\Butler Next Gen\FIB - Nightmare - Recode\interactions\getFormButton.js", "JavaScript", 96, 0, 0, 4, 13, 113
"c:\Users\Felix\OneDrive\Desktop\LSPD\Butler Next Gen\FIB - Nightmare - Recode\interactions\openTicketButton.js", "JavaScript", 68, 0, 0, 4, 12, 84
"c:\Users\Felix\OneDrive\Desktop\LSPD\Butler Next Gen\FIB - Nightmare - Recode\interactions\recruiterPanelButton.js", "JavaScript", 57, 0, 0, 4, 10, 71
"c:\Users\Felix\OneDrive\Desktop\LSPD\Butler Next Gen\FIB - Nightmare - Recode\interactions\setBlacklistButton.js", "JavaScript", 117, 0, 0, 9, 24, 150
"c:\Users\Felix\OneDrive\Desktop\LSPD\Butler Next Gen\FIB - Nightmare - Recode\interactions\startFormButton.js", "JavaScript", 662, 0, 0, 44, 88, 794
"c:\Users\Felix\OneDrive\Desktop\LSPD\Butler Next Gen\FIB - Nightmare - Recode\package.json", "JSON", 0, 37, 0, 0, 1, 38
"c:\Users\Felix\OneDrive\Desktop\LSPD\Butler Next Gen\FIB - Nightmare - Recode\utility\announcement.js", "JavaScript", 23, 0, 0, 7, 6, 36
"c:\Users\Felix\OneDrive\Desktop\LSPD\Butler Next Gen\FIB - Nightmare - Recode\utility\errors.js", "JavaScript", 31, 0, 0, 7, 6, 44
"c:\Users\Felix\OneDrive\Desktop\LSPD\Butler Next Gen\FIB - Nightmare - Recode\utility\logs.js", "JavaScript", 55, 0, 0, 9, 9, 73
"c:\Users\Felix\OneDrive\Desktop\LSPD\Butler Next Gen\FIB - Nightmare - Recode\utility\warnings.js", "JavaScript", 31, 0, 0, 7, 6, 44
"Total", "-", 3859, 37, 20, 262, 609, 4787